column_name	nullable	data_default
CODEMP	N	
CODFUNC	N	
NOMEFUNC	N	
CODEND	Y	
NUMEND	Y	
COMPLEMENTO	Y	
CODBAI	Y	
CODCID	Y	
CEP	Y	
TELEFONE	Y	
NUMCPS	Y	
UFCPS	Y	
CPF	Y	
PIS	Y	
IDENTIDADE	Y	
SEXO	Y	'M'
ESTADOCIVIL	Y	
NIVESC	Y	
ANOCHEGPAIS	Y	
NOMEMAE	Y	
NOMEPAI	Y	
DEPENDIRF	Y	
DEPENDSALFAM	Y	
MESDIA	Y	
DTNASC	Y	
DTADM	N	
DTDEM	Y	
DTAVISOPREVIO	Y	
DTCARTEIRASAUDE	Y	
CODBCO	Y	
CODAGE	Y	
CODCTABCO	Y	
CTAFGTS	Y	
PRIMEMPREGO	N	'S' 
VINCULO	Y	
TIPSAL	Y	'1'
TIPTAB	Y	'C'
SALBASE	Y	
SITUACAO	Y	'1'
SITSIND	Y	'N'
CODSIND	Y	
CODDEP	Y	
CODFUNCAO	Y	
CODCARGO	Y	
CODCARGAHOR	Y	
HORASSEM	Y	
AFASTFGTS	Y	
AFASTRAIS	Y	
CAUSAAFAST	Y	
CODSAQ	Y	
CONVMED	N	'N' 
NUMCARTAOPONTO	Y	
DEPENDCONVMED	Y	
PERCCONV	Y	
TIPRECEB	Y	'C'
MATRICULA	Y	
CODADMFGTS	Y	
CODADMFGTSII	Y	
TRABOUTRAEMP	N	'N' 
CIDNASC	Y	
IMAGEM	Y	
CODCATEG	Y	
DEFICIENTEFISICO	Y	'N'
SENHA	Y	
CODPARC	Y	0
DTOPTFGTS	N	
CODTOMADOR	N	0
RACAFUNCIONARIO	N	2
PARTPAT	N	'2' 
TITELEITORAL	Y	
ZONAELEITORAL	Y	
NRORESERVISTA	Y	
NACIONALPAIS	Y	
DIACADPIS	Y	
NROCNH	Y	
DTAFASTAMENTO	Y	
PERCADIANTAMENTO	Y	0
DTALTER	N	SYSDATE 
CELULAR	Y	
RNE	Y	
DTVALPAIS	Y	
SITPAIS	Y	
DTCPS	Y	
DTRG	Y	
ORGAORG	Y	
DTCADPIS	Y	
SECAOELEITORAL	Y	
DIASFERIAS	Y	
DTVENCEXP1	Y	
DTVENCEXP2	Y	
PRIMEIRACNH	Y	
VENCIMENTOCNH	Y	
CATEGORIACNH	Y	
REMUMINIMA	N	0
TIPCONTA	Y	
CODUSU	Y	
EMAIL	Y	
TIPDEFICIENCIA	N	0
CODCIDTRAB	N	0
CODGRUPOCTBZ	Y	
SINDICALIZADO	N	'N' 
NACIONALIDADE	Y	
CODEMPORIG	Y	
CODFUNCORIG	Y	
DTTRANSFERENCIA	Y	
REGIME	Y	
TIPPONTO	N	'S' 
DIAAPURAPONTO	N	0
DIRRECIPROCO	N	'N' 
CODCONVENIO	Y	
SERIECPS	Y	
PERCINSAL	Y	
PERCPERIC	Y	
POSSUIRRA	N	'N' 
QUEMPAGARRA	N	1
NROPROCESSORRA	Y	
DTLAUDORRA	Y	
CAIXAPOSTAL	Y	
NRONATURAL	Y	
DTNATURAL	Y	
NROPASSAPORTE	Y	
EMISSORPPORTE	Y	
UFPPORTE	Y	
DTEMIPPORTE	Y	
DTVALPPORTE	Y	
NRORIC	Y	
ORGAORIC	Y	
DTEMIRIC	Y	
CODCIDRIC	Y	
TIPCERTIDAO	Y	
NROCERTCIVIL	Y	
CARTORIO	Y	
NROLIVROREG	Y	
DTEMICERTCIVIL	Y	
CODCIDCERTCIVIL	Y	
PROVISAOFERIAS	N	'S' 
PROVISAO13	N	'S' 
NUREQUISICAO	Y	
DISPENSAPONTO	N	'N' 
CODCARREIRA	Y	
TEMPOPARCIAL	N	'N' 
SEMINTEGRAL	N	'N' 
NOVOEMPREGO	N	'N' 
DTQUITACAO	Y	
DIASAVISOPREVIO	Y	
COMPSALARIO	N	1
COMPENSASABADO	N	'N' 
NOMEARQHOMOLOGNET	Y	
MEI	N	'N' 
CODPAISNAC	Y	
ORGAORNE	Y	
DTEXPRNE	Y	
NROC	Y	
ORGAOOC	Y	
DTEXPOC	Y	
DTVALOC	Y	
ORGAOCNH	Y	
DTEXPCNH	Y	
DTCHEGPAIS	Y	
CASADOBR	N	'N' 
FILHOSBR	N	'N' 
OBSDEFICIENCIA	Y	
INDADMISSAO	Y	
REGIMETRAB	Y	
REGIMEJOR	Y	
CODCATEGESOCIAL	Y	
DTTERMINO	Y	
CONTTRABTEMP	Y	
CODEMPFUNCSUBST	Y	
CODFUNCSUBST	Y	
NUPROCESSOJUD	Y	
OPTFGTS	Y	
CNPJEMPANT	Y	
MATRICULAEMPANT	Y	
DTVINCEMPANT	Y	
OBSEMPANT	Y	
CNPJEMPCED	Y	
MATRICULAEMPCED	Y	
DTADMEMPCED	Y	
INFOONUS	Y	
DTASO	Y	
MEDICOASO	Y	
TELMEDICOASO	Y	
CRMMEDICOASO	Y	
UFCRMMEDASO	Y	
DTINC_ESOCIAL	Y	
DTULTENV_ESOCIAL	Y	
CAGEDADM	N	'N' 
SEGDESEMPREGO	N	'N' 
DTLOTENIS	Y	
NUMLOTENIS	Y	
CODEMPRESPNIS	Y	
NISENVIADO	N	'N' 
COMPLEMENTORG	Y	
UFRG	Y	
CODNIVEL	Y	
STEP	Y	
CODEMPFUNCSUP	Y	
CODFUNCSUP	Y	
NROFOLHAREG	Y	
REMUNERAMESANT	Y	0
UFCNH	Y	
CLASSTRABESTRANG	Y	
TRABAPOSENT	N	'N' 
OBSVARIAVEL	Y	
SALBASEANTERIOR	Y	
DTFIMQUARENTENA	Y	
MTVDESLIGTSV	Y	
NMSOCIAL	Y	
INFOCOTA	N	'N' 
JUSTCONTR	Y	
TPINCLCONTR	Y	
SUSPEXPAFAST	N	'S' 
TEMDESCASSIST	N	'N' 
TPINSCTOMADOR	Y	
TPINSCESTABVINC	Y	
NRINSCTOMADOR	Y	
CPFSUBSTITUIDO	Y	
JUSTPRORR	Y	
NRINSCESTABVINC	Y	
CODTPR	Y	
INDMV	N	0
ENVESOCIAL	N	'N' 
RECIBOESOCIAL	Y	
INIVALESOCIAL	Y	
FIMVALESOCIAL	Y	
TEMCONTRIBSINDICAL	N	'N' 
APRENDIZGRAVIDA	N	'N' 
SITESOCIAL	Y	
CODCATEGTRABCEDIDO	Y	
TPREGTRABCED	Y	
TPREGPREVCED	Y	
IDCONSIG	N	'N' 
INSCONSIG	Y	
NRCONTR	Y	
NRCERTOBITO	Y	
NUPROCESSOTRAB	Y	
INDNIF	Y	
NIFBENEF	Y	
INDCUMPRPARC	Y	
DTTRANSFDEST	Y	
CODEMPDEST	Y	
CODFUNCDEST	Y	
CNPJDESTTRANSF	Y	
CODMOTDESLIGTRANSF	Y	
REMUNBASE	Y	
SALPROFESSOR	Y	
DISPPEREXP	N	'N' 
METERG	Y	
OBSERVACAO	Y	
DSCATIVDES	Y	
JORNADAPROF	Y	
JORNADAESPPROF	Y	'N'
DTESOCIAL2205	Y	
DTESOCIAL2206	Y	
OBJDET	Y	
CPFANT	Y	
MATRICANT	Y	
DTALTCPF	Y	
OBSALTCPF	Y	
MATRICULAOLD	Y	
CADINI	Y	
SEMANASPORMES	Y	
CODGRUPOHORARIO	Y	
DTINIGRUPOHR	Y	
ORDEMGRUPOHR	Y	
DIASEMGRUPOHR	Y	
LOTACAOESOCIAL	Y	NULL
PERTENCEDP	N	'N' 
CONTRATOSUSP	N	'N' 
DTVENCEXP1OR	Y	
DTVENCEXP2OR	Y	
CODMAD	Y	
CODMADDEM	Y	
SALAJUSTADOSIND	Y	
REPLIDER	Y	
USUVPJSUP	Y	
ADERIMP927	Y	'S'
SALBASECPU	Y	
HORASSEMCPU	Y	
PERREDCPU	Y	
AJUDACOMP	N	'N' 
SUSPCONTRATO	N	'N' 
AFASTAMENTO	Y	
OBSERVACAOMP	Y	
SEQCPU	Y	
DTINICIORED	Y	
DTFIMRED	Y	
TELEGRAMID	Y	
DTFIMCONTRINT	Y	
CODLTR	Y	
SALBASERED	Y	
HORASSEMRED	Y	
APRENDCONTRIND	N	'N' 
NRINSCINFOCELETISTA	Y	
TRANSFEXTERNA	N	'N' 
INDRETIFESOCIAL2206	Y	
DSCALT	Y	
NUMPROCTSVE	Y	
NRPROCTRAB	Y	
BLOQUEIABATIDAONLINE	Y	'N'
TMPRESIDTRABESTRANG	Y	
CONDINGESTRANG	Y	
MOTEXPATRIADO	Y	
DISPENSAMATRICULA	Y	'N'
CTPSDIGITAL	N	'N' 
DTFIMREMUN	Y	
FORMTRIBU	Y	
ENDFISCEXT	Y	
INDSITREMUNDESLIG	Y	
NATATIVIDADE	Y	
RECIBOESOCIAL2205	Y	
AFASTFGTSANT	Y	
RECIBOESOCIAL2206	Y	
TPINSCAPREND	Y	
DTALTS2200	Y	
MOTDESLIGESOCIAL	Y	
CODTPRJUD	Y	
CAUSAAFASTANT	Y	
CNPJPRAT	Y	
POSSUIFILHOS	Y	
ORIENTACAOSEXUAL	Y	
MOTDESLIGESOCIALANT	Y	
IDENTIDADEGENERO	Y	
NRPROCTRABANT	Y	
AFASTRAISANT	Y	
NATATIVIDADEANT	Y	
RECIBOESOCIAL2200	Y	
DTDEMJUD	Y	
CODCATEGESOCIALANT	Y	
NRINSCAPREND	Y	
MATANOTJUD	Y	
PVD	Y	
DTADMJUD	Y	
DTALTS2299	Y	
INDADMISSAOANT	Y	
NRPROCTRABDESLIG	Y	
CNPJENTQUAL	Y	
DTSENTPROCTRAB	Y	
SITUACAOANT	Y	
DTDISPENSAPONTO	Y	
CODLOCALPONTO	Y	
VALIDADO	Y	
TRANSFSEMONUSCEDENTE	Y	
